6 30
28 0
xxxxxx
x    x
x    x
x  x x
x  x x
x  xxx
x  x x
x  x x
x  x x
x  x x
x    x
xxxx x
x  x x
x  x x
x  x x
x  x x
x  x x
x    x
xxx xx
x x  x
x  x x
xx   x
x  x x
x xx x
x  x x
xx x x
x  x x
xx x x
   x x
xxxxxx
